11111111111111*10000000000000000000000000000000000000000000000000000000000000000
00000000*00000000000000000000000000000000000000000000000000000000000001001111000
00011111*00010000000000000000000000000000000000000000000000000000000001000001000
00000011111111111$$0000000000001111******111111111111100000000000000001111111000
00000001000000000000000011111111111111110000000000000000000000000000001000001000
00111001000000000000000010000001111111110000001000000000000000000000001000001000
0010100101111111***1111111110001111111110000001011111111111111111110001011101000
00101001000100000000000000010001111111110000001000100000000000100010001010101100
00101001100100011111111100010001111111110000001000100001001111100010001010101000
00101000100100000100000100010000100000000000001000100001000000100010001110101000
00101000111110000100100100010111111000000010001000100001111100100010000000101110
00101000000010000100100110010100001000000010001001100001000100000011111111100010
00#01000000010000100100011110101111111100010001011000001000000000010000000000110
000010000000100001001000000001000000001000100011100000011111*1111110000000000100
01111000111010000100100000000111111000111111000000000000000000000000000011111100
01000000101010000000100000000000001000000000000000000000000000000000000000100000
0111100010101111*111111111111111111111111000000000000000000000000000000000100000
00001000101000000000000001100000000000000000000000000000000000000000000000100000
00001000101111111000111111000000000000000000000000000000000000000000000000100000
00111000100000001000001001000000000000000000000000000000000000000000000000100000
00100000111100001011101001000000000000000000000000000000000000000000000000100000
00111111100000001010101001111111111*11111111111111111111111111111111111111110000
00000000000000001110111000000000000000000000000000000000000000000000000100000000
00000000000000000000000000000000000000000000000000000000000000000000000111111111
